1 472 216 16 16 0 0 0 1000 -1000 1 
1 488 216 16 16 0 0 0 1000 -1000 1 
1 504 216 16 16 0 0 0 1000 -1000 1 
1 520 216 16 16 0 0 0 1000 -1000 1 
1 536 216 16 16 0 0 0 1000 -1000 1 
1 552 216 16 16 0 0 0 1000 -1000 1 
1 568 216 16 16 0 0 0 1000 -1000 1 
1 104 408 16 16 0 0 0 1000 -1000 1 
1 120 408 16 16 0 0 0 1000 -1000 1 
1 136 408 16 16 0 0 0 1000 -1000 1 
1 152 408 16 16 0 0 0 1000 -1000 1 
1 168 408 16 16 0 0 0 1000 -1000 1 
1 184 408 16 16 0 0 0 1000 -1000 1 
1 792 552 16 16 0 0 0 1000 -1000 1 
1 808 552 16 16 0 0 0 1000 -1000 1 
1 824 552 16 16 0 0 0 1000 -1000 1 
1 152 760 16 16 0 0 0 1000 -1000 1 
1 168 760 16 16 0 0 0 1000 -1000 1 
1 184 760 16 16 0 0 0 1000 -1000 1 
1 200 760 16 16 0 0 0 1000 -1000 1 
1 216 760 16 16 0 0 0 1000 -1000 1 
1 232 760 16 16 0 0 0 1000 -1000 1 
1 248 760 16 16 0 0 0 1000 -1000 1 
1 264 760 16 16 0 0 0 1000 -1000 1 
1 280 760 16 16 0 0 0 1000 -1000 1 
1 296 760 16 16 0 0 0 1000 -1000 1 
