1 450.233 648.698 8 8 -400 246.918 0 1000 1 
1 -122.696 792.261 8 8 -400 296.74 0 1000 1 
1 50.0066 748.005 8 8 -400 2.23 0 1000 1 
0 2000 2000 8 8 0 0 0 1000 1 
0 2000 2000 8 8 0 0 0 1000 1 
0 2000 2000 8 8 0 0 0 1000 1 
1 1142.44 667.012 8 8 -400 43.893 0 1000 1 
1 341.091 748.005 8 8 -400 2.23 0 1000 1 
1 741.325 748.005 8 8 -400 2.23 0 1000 1 
1 720.013 540 8 8 -400 0 0 0 1 
1 36 748.005 8 8 -400 2.23 0 1000 1 
1 320.424 713.596 8 8 -400 390.046 0 1000 1 
