1 136 248 16 16 0 0 0 2000 -1000 1 
1 152 248 16 16 0 0 0 2000 -1000 1 
1 168 248 16 16 0 0 0 2000 -1000 1 
1 184 248 16 16 0 0 0 2000 -1000 1 
1 200 248 16 16 0 0 0 2000 -1000 1 
1 216 248 16 16 0 0 0 2000 -1000 1 
1 584 536 16 16 0 0 0 2000 -1000 1 
1 600 536 16 16 0 0 0 2000 -1000 1 
1 616 536 16 16 0 0 0 2000 -1000 1 
1 632 536 16 16 0 0 0 2000 -1000 1 
1 648 536 16 16 0 0 0 2000 -1000 1 
1 56 760 16 16 0 0 0 2000 -1000 1 
1 72 760 16 16 0 0 0 2000 -1000 1 
1 88 760 16 16 0 0 0 2000 -1000 1 
1 104 760 16 16 0 0 0 2000 -1000 1 
1 1032 760 16 16 0 0 0 2000 -1000 1 
1 1048 760 16 16 0 0 0 2000 -1000 1 
1 1064 760 16 16 0 0 0 2000 -1000 1 
1 1080 760 16 16 0 0 0 2000 -1000 1 
1 1096 760 16 16 0 0 0 2000 -1000 1 
1 1112 760 16 16 0 0 0 2000 -1000 1 
1 1128 760 16 16 0 0 0 2000 -1000 1 
