1 808 248 16 16 0 0 0 2000 -1000 1 
1 824 248 16 16 0 0 0 2000 -1000 1 
1 840 248 16 16 0 0 0 2000 -1000 1 
1 856 248 16 16 0 0 0 2000 -1000 1 
1 872 248 16 16 0 0 0 2000 -1000 1 
1 888 248 16 16 0 0 0 2000 -1000 1 
1 904 248 16 16 0 0 0 2000 -1000 1 
1 296 584 16 16 0 0 0 2000 -1000 1 
1 312 584 16 16 0 0 0 2000 -1000 1 
1 328 584 16 16 0 0 0 2000 -1000 1 
1 344 584 16 16 0 0 0 2000 -1000 1 
1 360 584 16 16 0 0 0 2000 -1000 1 
1 376 584 16 16 0 0 0 2000 -1000 1 
1 520 760 16 16 0 0 0 2000 -1000 1 
1 536 760 16 16 0 0 0 2000 -1000 1 
1 552 760 16 16 0 0 0 2000 -1000 1 
1 568 760 16 16 0 0 0 2000 -1000 1 
1 584 760 16 16 0 0 0 2000 -1000 1 
1 600 760 16 16 0 0 0 2000 -1000 1 
1 616 760 16 16 0 0 0 2000 -1000 1 
1 632 760 16 16 0 0 0 2000 -1000 1 
1 648 760 16 16 0 0 0 2000 -1000 1 
1 664 760 16 16 0 0 0 2000 -1000 1 
1 680 760 16 16 0 0 0 2000 -1000 1 
1 696 760 16 16 0 0 0 2000 -1000 1 
